#Области
Область - Region
ПрограммныйИнтерфейс - Public
СлужебныйПрограммныйИнтерфейс - Internal
СлужебныеПроцедурыИФункции - Private
ОписаниеПеременных - Variables
ОбработчикиСобытий - EventHandlers
ОбработчикиСобытийФормы - FormEventHandlers
Инициализация - Initialize
#Основные операторы
КонецОбласти - EndRegion
НаСервере - AtServer
НаКлиенте - AtClient
НаСервереБезКонтекста - AtServerNoContext
НаКлиентеНаСервереБезКонтекста - AtClientAtServerNoContext
НаКлиентеНаСервере - AtClientAtServer
Функция - Function
Возврат - Return
КонецФункции - EndFunction
Процедура - Procedure
КонецПроцедуры - EndProcedure
Неопределено - Undefined
Перем - Var
Ждать - Await
Выполнить - Execute
Новый - New
ДобавитьОбработчик - AddHandler
УдалитьОбработчик - RemoveHandler
Для - For
По - To
Цикл - Do
КонецЦикла - EndDo
Каждого - Each
Из - In
Пока - While
Перейти - Goto
Если - If
Тогда - Then
ИначеЕсли - ElsIf
Иначе - Else
КонецЕсли - EndIf
Попытка - Try
Исключение - Except
КонецПопытки - EndTry
ВызватьИсключение - Raise
Истина - True
Ложь - False
И - And
Не - Not
Или - Or
Экспорт - Export